SO ./textures/wall_north.xpm
NO ./textures/wall_south.xpm
WE ./textures/wall_west.xpm
EA ./textures/wall_east.xpm

CO ./textures/coin1.xpm ./textures/coin2.xpm ./textures/coin3.xpm ./textures/coin4.xpm ./textures/coin5.xpm ./textures/coin6.xpm

DO ./textures/door1.xpm ./textures/door2.xpm ./textures/door3.xpm ./textures/door4.xpm ./textures/door5.xpm ./textures/door6.xpm ./textures/door7.xpm ./textures/door8.xpm ./textures/door9.xpm ./textures/door10.xpm

F 116,84,20
C 135,206,235

111111111111111111111111111111
100000000000000C00000000000001
100010110000000000000000011001
100011001111100001211100101001
100000000C00100110000101110001
100000000000001000000100110001
111112111000011000000100010001
100000001000010000001100010001
1000C0001000101111000000010001
100000001000000000000000011001
100000001000000000000000000001
100000011000000000112111100001
100000010000000001100000011001
100000010000000110000000001001
100000010000000111111111001001
100000010000001010000011000001
111100010000001011000110000001
110011110000001001001100000001
110000000000001001000000000001
1110000000C0001001110000000001
101111100000001N00010000000001
100000111000000100000010000001
100000000100000100000110111001
100000000100000100000100000101
100000000100000010000100000011
10C000000100000010000010000001
100000001000000000000010000001
100000011000000000000010000001
100000110000000000000010000001
111100100000000000000001100001
111011100000000000000001000001
101100000000000C00000001111101
100111110000000000000000000001
100000011111000000000000000001
100000000001000000000000000001
100000000010000000011110111001
100000000001111111100000011001
100000000000000001100000010001
100000000000000001000000100001
111111111111111111111111111111