NO ./textures/wall_north.xpm 
SO ./textures/wall_south.xpm 
WE ./textures/wall_west.xpm 
EA ./textures/wall_east.xpm 
CO ./textures/baby_frame_0_delay-0.18s.xpm ./textures/baby_frame_1_delay-0.18s.xpm ./textures/baby_frame_2_delay-0.18s.xpm ./textures/baby_frame_3_delay-0.18s.xpm ./textures/baby_frame_4_delay-0.18s.xpm ./textures/baby_frame_5_delay-0.18s.xpm ./textures/baby_frame_6_delay-0.18s.xpm ./textures/baby_frame_7_delay-0.18s.xpm 
DO ./textures/door1.xpm ./textures/door10.xpm ./textures/door2.xpm ./textures/door3.xpm ./textures/door4.xpm ./textures/door5.xpm ./textures/door6.xpm ./textures/door7.xpm ./textures/door8.xpm ./textures/door9.xpm 
F 116,84,20
C 135,206,235

111111111111111111111111111111
100000000000000000000000000001
100000000000000001100000000001
100000000000001110110000000001
100000000001110000011000000001
100000000010000000001000000001
100000001100000000001100000001
100000011000000000000100000001
1000001100000C000C000100000001
100000100000000000000010000001
100001100000000000000010000001
1000010000C0000000C00001000001
10001000000000W000000001000001
100010000000000000000001000001
1001000000000000C0000000100001
1001000000000C0000000000100001
101100000000000000000000010001
10110000C000000000000000010001
10011000000000000000C000010001
100001100000000C00000000010001
100000011000000000000000010001
100000000100000000000000010001
100000000001100000000000010001
100000000000001011000000010001
100000000000000000011101110001
100000000000000000000000000001
100000000000000000000000000001
100000000000000000000000000001
100000000000000000000000000001
111111111111111111111111111111
