NO ./textures/wall_north.xpm 
SO ./textures/wall_south.xpm 
WE ./textures/wall_west.xpm 
EA ./textures/wall_east.xpm 
CO ./textures/frame_0_delay-0.1s.xpm ./textures/frame_1_delay-0.1s.xpm ./textures/frame_2_delay-0.1s.xpm ./textures/frame_3_delay-0.1s.xpm ./textures/frame_4_delay-0.1s.xpm ./textures/frame_5_delay-0.1s.xpm ./textures/frame_6_delay-0.1s.xpm ./textures/frame_7_delay-0.1s.xpm 
DO ./textures/door1.xpm ./textures/door10.xpm ./textures/door2.xpm ./textures/door3.xpm ./textures/door4.xpm ./textures/door5.xpm ./textures/door6.xpm ./textures/door7.xpm ./textures/door8.xpm ./textures/door9.xpm 
F 188,143,143
C 255,228,225

111111111111111111111111111111
100000000000000000000000000001
100000000000000000000000000001
100000000000000000000000000001
100000111111111111000000000001
100001100000000000110000000001
100001000000000000010000000001
100001000000000000010000000001
100000100000000000001000000001
100000100000000000001000000001
100000100000000000001000000001
1000001000000C0000001000000001
1000001000C0000000001000000001
100000100000000000001000000001
100001000000E00000001000000001
100001000000000000000100000001
10000100000000C000000100000001
1000010000C0000000000100000001
100001000000000000000100000001
100001000000C00000000100000001
100001000000000000000100000001
100001100000000000000100000001
100000101000000000001000000001
100000000100000000010000000001
100000000011111101110000000001
100000000000000110000000000001
100000000000000000000000000001
100000000000000000000000000001
100000000000000000000000000001
111111111111111111111111111111
