NO ./textures/wall_north.xpm 
SO ./textures/wall_south.xpm 
WE ./textures/wall_west.xpm 
EA ./textures/wall_east.xpm 
CO ./textures/nezuko_frame_0_delay-0.2s.xpm ./textures/nezuko_frame_1_delay-0.2s.xpm ./textures/nezuko_frame_2_delay-0.2s.xpm ./textures/nezuko_frame_3_delay-0.2s.xpm ./textures/nezuko_frame_4_delay-0.2s.xpm ./textures/nezuko_frame_5_delay-0.2s.xpm ./textures/nezuko_frame_6_delay-0.2s.xpm ./textures/nezuko_frame_7_delay-0.2s.xpm ./textures/nezuko_frame_8_delay-0.2s.xpm 
DO ./textures/door1.xpm ./textures/door10.xpm ./textures/door2.xpm ./textures/door3.xpm ./textures/door4.xpm ./textures/door5.xpm ./textures/door6.xpm ./textures/door7.xpm ./textures/door8.xpm ./textures/door9.xpm 
F 188,143,143
C 255,228,225

111111111111111111111111111111
100000000000000000000000000001
100000000000000000000000000001
100000000000000000000000000001
100000000000000000000000000001
100000000011111111000000000001
100000001100000000100000000001
100000010000000000010000000001
1000001100C0000000001000000001
100000100000000000000100000001
1000000000000000C0000100000001
100001000000000000000010000001
100010000000000000000010000001
10001000000C000C00000001000001
100110000000000000000001000001
10010000C0000N0000000001000001
100100000000000000C00001000001
1010000000000000C0000000100001
101000000000000000000000100001
10010000000000000000C000100001
10011000000C00C000000001000001
1000100000000000000C0001000001
100000110000000000000011000001
100000001100000000000010000001
100000000011100000000100000001
100000000000011111101100000001
100000000000000000111000000001
100000000000000000000000000001
100000000000000000000000000001
111111111111111111111111111111
